Bogføringsdato;Beløb;Afsender;Modtager;Navn;Beskrivelse;Saldo;Valuta;Afstemt
2023/03/31;-1,25;4399493582;;;Gebyr, overf. 28.02 - 31.03.2023   Netbank, stk. 1;15143,90;DKK;
2023/03/24;100,00;;4399493582;;Kalk;15145,15;DKK;
2023/03/17;-800,00;4399493582;;;Kalk Udlæg Kristian;15045,15;DKK;
2023/03/13;450,00;;4399493582;;Kontingent - Lasse P           agh;15845,15;DKK;
2023/03/13;450,00;;4399493582;;David Teg - medlem;15395,15;DKK;
2023/03/08;450,00;;4399493582;;medlemsskab - Joseph           ine Dodt;14945,15;DKK;
2023/03/07;450,00;;4399493582;;Overførsel;14495,15;DKK;
2023/03/03;450,00;;4399493582;;Jakob Aaby Nielsen;14045,15;DKK;