Bogføringsdato;Beløb;Afsender;Modtager;Navn;Beskrivelse;Saldo;Valuta;Afstemt
2023/04/19;450,00;;4399493582;;Fra Alexander Mar...;15482,90;DKK;
2023/04/17;450,00;;4399493582;;Andreas kontingent;15032,90;DKK;
2023/04/14;525,00;;4399493582;;Fra Rasmus Sriboorap;14582,90;DKK;
2023/04/12;450,00;;4399493582;;Overførsel;14057,90;DKK;
2023/04/11;-50,00;4399493582;;;Netbank brugeraftaler .;13607,90;DKK;
2023/04/11;-250,00;4399493582;;;Netbank gebyr  standard 1. kvartal;13657,90;DKK;
2023/04/11;450,00;;4399493582;;2. kvartal 2023 - Ra           smus Nørskov;13907,90;DKK;
2023/04/04;450,00;;4399493582;;Membership - Lenka;13457,90;DKK;
2023/04/03;-2136,00;4399493582;;;OVF. 5909523453;13007,90;DKK;